32,24,,,,,,,,,,,,,,,,,,,,,,,,,,,,,,
8,8,8,8,8,8,8,8,8,8,8,8,8,8,8,8,8,8,8,8,8,8,8,8,8,8,8,8,8,8,8,8
8,0,0,0,2,0,0,0,0,0,0,0,1,0,1,1,1,1,0,1,0,0,0,2,0,0,0,0,0,0,0,8
8,0,0,0,2,0,0,0,0,0,0,0,1,0,1,3,0,1,0,1,0,0,0,2,0,0,0,0,0,0,0,8
8,0,0,0,2,0,0,0,0,0,0,0,1,0,1,0,0,1,0,1,0,0,0,2,0,0,0,0,0,0,0,8
8,0,0,0,2,0,0,0,2,0,0,0,1,0,1,1,1,1,0,1,0,0,0,2,0,0,0,2,0,0,0,8
8,0,0,0,2,0,0,0,2,0,0,0,1,0,1,1,1,1,0,1,0,0,0,2,0,0,0,2,0,0,0,8
8,0,0,0,2,0,0,0,2,0,0,0,1,0,1,0,4,1,0,1,0,0,0,2,0,0,0,2,0,0,0,8
8,0,0,0,2,0,0,0,2,0,0,0,1,0,1,0,0,1,0,1,0,0,0,2,0,0,0,2,0,0,0,8
8,0,0,0,2,0,0,0,2,0,0,0,1,0,1,1,1,1,0,1,0,0,0,2,0,0,0,2,0,0,0,8
8,0,0,0,2,0,0,0,2,0,0,0,1,0,1,1,1,1,0,1,0,0,0,2,0,0,0,2,0,0,0,8
8,0,0,0,2,0,0,0,2,0,0,0,1,0,1,0,0,1,0,1,0,0,0,2,0,0,0,2,0,0,0,8
8,0,0,0,2,0,0,0,2,0,0,0,1,0,1,6,0,1,0,1,0,0,0,2,0,0,0,2,0,0,0,8
8,0,0,0,2,0,0,0,2,0,0,0,1,0,1,0,0,1,0,1,0,0,0,2,0,0,0,2,0,0,0,8
8,0,0,0,2,0,0,0,2,0,0,0,1,0,1,0,0,1,0,1,0,0,0,2,0,0,0,2,0,0,0,8
8,0,0,0,2,0,0,0,2,0,0,0,1,0,1,1,1,1,0,1,0,0,0,2,0,0,0,2,0,0,0,8
8,0,0,0,2,0,0,0,2,0,0,0,1,0,1,1,1,1,0,1,0,0,0,2,0,0,0,2,0,0,0,8
8,0,0,0,2,0,0,0,2,0,0,0,1,0,1,5,0,1,0,1,0,0,0,2,0,0,0,2,0,0,0,8
8,0,0,0,2,0,0,0,2,0,0,0,1,0,1,0,0,1,0,1,0,0,0,2,0,0,0,2,0,0,0,8
8,0,0,0,2,0,0,0,2,0,0,0,1,0,1,1,1,1,0,1,0,0,0,2,0,0,0,2,0,0,0,8
8,0,0,0,2,0,0,0,2,0,0,0,1,0,1,1,1,1,0,1,0,0,0,2,0,0,0,2,0,0,0,8
8,0,0,0,0,0,0,0,2,0,0,0,1,0,1,0,7,1,0,1,0,0,0,0,0,0,0,2,0,0,0,8
8,0,0,0,0,0,0,0,2,0,0,0,1,0,1,0,0,1,0,1,0,0,0,0,0,0,0,2,0,0,0,8
8,0,0,0,0,0,0,0,2,0,0,0,1,0,1,1,1,1,0,1,0,0,0,0,0,0,0,2,0,0,0,8
8,8,8,8,8,8,8,8,8,8,8,8,8,8,8,8,8,8,8,8,8,8,8,8,8,8,8,8,8,8,8,8
